%%%%%%%%%%%%%%%%%%%%%%%%%%%%
%............%%............%
%.%%%%.%%%%%.%%.%%%%%.%%%%.%
%..........................%
%.%%%%.%%.%%%%%%%%.%%.%%%%.%
%......%%....%%....%%......%
%%%%%%.%%%%% %% %%%%%.%%%%%%
%......   %.    .%   ......%
%%%%%%.%% %%%%%%%% %%.%%%%%%
%............%%............%
%.%%%%.%%%%%.%%.%%%%%.%%%%.%
%....%....... P.......%....%
%%%%.%.%%.%%%%%%%%. %.%.%%%%
%......%%....%%....%%......%
%.%%%%%%%%%%.%%.%%%%%%%%%%.%
%..........................%
%%%%%%%%%%%%%%%%%%%%%%%%%%%%